. . . . .                           .           . .     .              
                    .   . . .   . . .   .   .       .     . . . .   .  
. .   .   . .   .   .     . .         . .   . .   . . .         . . . .
  . . .     .   .   .   . . .   .   .   .     .         .   . .     . .
.   .       .   . . . . . . .   .     . . .   . .   .           .   . .
.   . .     . .   .         .   . .       . .         .       . .     .
  .   . .   . . . . . . .   . . . . .     . . .   . . . .     .   . . .
  . . . .               .       . . . .     . .     . . . .   .       .
  .   . . . . .   .   .   .   . . . . . . . . .               .       .
    . . . .   . .   . .   .     .             . . .   . .       .     .
.     . . . . . .   . . .   .   . . .   .     . . .   .   .   .   .   .
          .               .   . . .       .     . .   . . .   . .   . .
    . .     .   . . . .   .       . . .     .   . .       .   .   .    
  .   . .   .   . . .     .   . .   .   .         .     . .     . . . .
    .   . .   .       .   .       .   . . . . .   . . .   .           .
  . .   . .   . . .   .   .   .   .               .     .   .   .     .
    . . . .     . . .   . . . .   . . .   . .       . . .     . .   . .
  .       . .     . .         .   . . .   . . . .     . .       .     .
      .   . . .   . . . . . . .       .         .   .   . .           .
. . .   . .             .   . . . . .   . .   . .     .         . . . E
            .   . .   . . . . .   .   . . . . . . .       .       .    
  . .   .   .   .     .       .   .       . .     . . . .     .     . .
  . .   .   . .   .   . . . . . . . . .       .   . . . . . .   . . . .
      . . . . .   .           . . .   .   .   .       .   .   .       .
. .     .   .   . . . . . .       . . . . . .   .   .   . .   . . .   .
  . .     .   .         .   . . .         . . . .   . . . .     . .    
                . .   . . .       . .   . . . .   .       . . .   . . .
. . .             .   .     . .     .         .     .       . .     . .
    . .     . . . .     .     .   . .               .   .     . .      
  . . . .         .   .   .   .     . . .   . . .   . . . .   . .   . .
  . . . .   .   .   . . . . . . .   . .   .     .       . .   . . . . .
      . . . .   .         .     .     .             .   . .            
  .     .   .   . . . .     .     .   .   . . . . . .   . . . .   . . .
. .   . .   .           . .   .                   . .       . .        
  .     . . .   .   .     . .     . .               . .       .     . .
. .       . . . . . .   . . . . . . . . . . . . .     . . . . . .     .
